111111111111111111111111
100000001100001000000001
101000010000000100000001
100000000111000000000011
100010000000000000000001
100000011010000010000001
110000000100000010000001

1000000000000100000P0101
10100000000001001000E001
100000000000000001000011
11000000000000011000C001
111111111111111111111111
