111111111111	111111111111
110000001E00	000000000001
100000000001	001110000001
100000000000	010000011001
100000000000	0000001000C1
10000000P010	000000001001
101001100000	000000000001
110010000000	000000C00011
110000000001	011100000001
101100000010	100000000001
100000010000	000000000001
111111111111	111111111111
