111111111111111111111111
100100000001100001000011
10000C000000000000000001
101000000001000001000001
1000000P0000000000000011
100000000100000000000001
100000000000100000000001
100100000000001000001101
1C10000000000011C0001001
100100100000000100101001
1000101100100000000000E1
111111111111111111111111
