1111111111111111111111101
1001000000011000010000101
10000C0000000000000000001
1010000000010000010000001
1000000P00000000000000101
1000000001000000000000001
1000000000001000000000001
1001000000000010000011001
1C10000000000011C00010001
1001001000000001001010001
1000101100100000000000E01
1111111111111111111111111
