111111111111111111111111
101010110E0000000000C001
100000100100100000000001
100000000000110000010001
100000000000000000000011
101000000101100000001001
10000P010000000000000011
1000000010110P0000010101
100000001000000000100001
100000000000100000000001
100000000100010000000001
111111111111111111111111
