111111111111111111111111
110000001E00000000000001
100000000001001110000001
100000000000010000011001
1000000000000000001000C1
10000000P010000000001001
101001100000000000000001
110010000000000000C00011
110000000001011100000001
10110000E010100000000001
100000010000000000000001
111111111111111111111111
