111111111111111111111111
101000001000000000000011
100100000000000000000001
100000000101100000000001
100000000000100111000001
10000000C010000010000101
101010000000100000000101
100010000100000000100001
100010000010000000000001
101100000000000000001001
100000000001000P01000001
111111111111111111111111
