111111111111111111111111
100000000001010000000001
100001000000000010000011
100000000000001000000001
100001100011C00000000001
110000011000000000000101
100000000000000001000011
100000000000000001000101
100000001000001011000001
100000000010110010000001
10011000000E0101C10000P1
111111111111111111111111
